{
  "tracks" : 4,
  "speed" : 2,
  "length" : 15,
  "samples" : 0,
  "bpm" : 125,
  "patternsRaw" : {
    "7" : [
      "00 | G#5 01v01 ...|... .. .. ...|G#3 03v01 ...|C-5 04v01 ...",
      "01 | ... .. .. ...|... .. .. ...|... .. .. ...|=== .. .. ...",
      "02 | ... .. .. ...|... .. .. ...|... .. .. ...|... .. .. ...",
      "03 | ... .. .. ...|... .. .. ...|... .. .. ...|... .. .. ...",
      "04 | G#4 01v01 ...|... .. .. ...|G#2 03v01 ...|... .. .. ...",
      "05 | ... .. .. ...|... .. .. ...|... .. .. ...|... .. .. ...",
      "06 | A#5 01v01 SC0|... .. .. ...|A#3 03v01 SC0|... .. .. ...",
      "07 | ... .. .. ...|... .. .. ...|... .. .. ...|... .. .. ...",
      " -    -    -    -    -    -    -    -    -    -    -    -   ",
      "08 | ... .. .. ...|... .. .. ...|... .. .. ...|D-5 04v01 ...",
      "09 | ... .. .. ...|... .. .. ...|... .. .. ...|... .. .. ...",
      "0A | ... .. .. ...|... .. .. ...|... .. .. ...|=== .. .. ...",
      "0B | C-5 01v01 ...|... .. .. ...|C-3 03v01 ...|... .. .. ...",
      "0C | C-6 01v01 SC0|... .. .. ...|C-4 03v01 SC0|... .. .. ...",
      "0D | ... .. .. ...|... .. .. ...|... .. .. ...|... .. .. ...",
      "0E | ... .. .. ...|... .. .. ...|... .. .. ...|... .. .. ...",
      "0F | ... .. .. ...|... .. .. ...|... .. .. ...|... .. .. ...",
      " -    -    -    -    -    -    -    -    -    -    -    -   ",
      "10 | A#5 01v01 ...|... .. .. ...|A#3 03v01 ...|C-5 04v01 ...",
      "11 | ... .. .. ...|... .. .. ...|... .. .. ...|=== .. .. ...",
      "12 | ... .. .. ...|... .. .. ...|... .. .. ...|... .. .. ...",
      "13 | ... .. .. ...|... .. .. ...|... .. .. ...|... .. .. ...",
      "14 | A#4 01v01 ...|... .. .. ...|A#2 03v01 ...|... .. .. ...",
      "15 | ... .. .. ...|... .. .. ...|... .. .. ...|... .. .. ...",
      "16 | C-6 01v01 SC0|... .. .. ...|C-4 03v01 SC0|... .. .. ...",
      "17 | ... .. .. ...|... .. .. ...|... .. .. ...|... .. .. ...",
      " -    -    -    -    -    -    -    -    -    -    -    -   ",
      "18 | ... .. .. ...|... .. .. ...|... .. .. ...|C-5 04v01 ...",
      "19 | ... .. .. ...|... .. .. ...|... .. .. ...|=== .. .. ...",
      "1A | ... .. .. ...|... .. .. ...|... .. .. ...|C-5 04v01 ...",
      "1B | C-5 01v01 ...|... .. .. ...|C-3 03v01 ...|=== .. .. ...",
      "1C | C#6 01v01 SC0|... .. .. ...|C#4 03v01 SC0|C-5 04v01 ...",
      "1D | ... .. .. ...|... .. .. ...|... .. .. ...|=== .. .. ...",
      "1E | ... .. .. ...|... .. .. ...|... .. .. ...|... .. .. ...",
      "1F | ... .. .. ...|... .. .. ...|... .. .. ...|... .. .. ..."
    ],
    "3" : [
      "00 | C-6 01v01 ...|... .. .. ...|C-4 03v01 ...|C-5 04v01 ...",
      "01 | ... .. .. ...|... .. .. ...|... .. .. ...|=== .. .. ...",
      "02 | ... .. .. ...|... .. .. ...|... .. .. ...|... .. .. ...",
      "03 | ... .. .. ...|... .. .. ...|... .. .. ...|... .. .. ...",
      "04 | ... .. .. ...|... .. .. ...|... .. .. ...|... .. .. ...",
      "05 | === .. .. ...|... .. .. ...|=== .. .. ...|... .. .. ...",
      "06 | C-6 01v01 ...|... .. .. ...|C-4 03v01 ...|... .. .. ...",
      "07 | ... .. .. ...|... .. .. ...|... .. .. ...|... .. .. ...",
      " -    -    -    -    -    -    -    -    -    -    -    -   ",
      "08 | ... .. .. ...|... .. .. ...|... .. .. ...|D-5 04v01 ...",
      "09 | ... .. .. ...|... .. .. ...|... .. .. ...|... .. .. ...",
      "0A | ... .. .. ...|... .. .. ...|... .. .. ...|=== .. .. ...",
      "0B | ... .. .. ...|... .. .. ...|... .. .. ...|... .. .. ...",
      "0C | C-5 01v01 ...|... .. .. ...|C-3 03v01 ...|... .. .. ...",
      "0D | ... .. .. ...|... .. .. ...|... .. .. ...|... .. .. ...",
      "0E | ... .. .. ...|... .. .. ...|... .. .. ...|... .. .. ...",
      "0F | ... .. .. ...|... .. .. ...|... .. .. ...|... .. .. ...",
      " -    -    -    -    -    -    -    -    -    -    -    -   ",
      "10 | G-5 01v01 ...|... .. .. ...|G-3 03v01 ...|C-5 04v01 ...",
      "11 | ... .. .. ...|... .. .. ...|... .. .. ...|=== .. .. ...",
      "12 | ... .. .. ...|... .. .. ...|... .. .. ...|... .. .. ...",
      "13 | ... .. .. ...|... .. .. ...|... .. .. ...|... .. .. ...",
      "14 | G-4 01v01 ...|... .. .. ...|G-2 03v01 ...|... .. .. ...",
      "15 | ... .. .. ...|... .. .. ...|... .. .. ...|... .. .. ...",
      "16 | G#5 01v01 SC0|... .. .. ...|G#3 03v01 SC0|... .. .. ...",
      "17 | ... .. .. ...|... .. .. ...|... .. .. ...|... .. .. ...",
      " -    -    -    -    -    -    -    -    -    -    -    -   ",
      "18 | ... .. .. ...|... .. .. ...|... .. .. ...|C-5 04v01 ...",
      "19 | ... .. .. ...|... .. .. ...|... .. .. ...|=== .. .. ...",
      "1A | G#4 01v01 ...|... .. .. ...|G#2 03v01 ...|C-5 04v01 ...",
      "1B | ... .. .. ...|... .. .. ...|... .. .. ...|=== .. .. ...",
      "1C | D#6 01v01 SC0|... .. .. ...|D#4 03v01 SC0|C-5 04v01 ...",
      "1D | ... .. .. ...|... .. .. ...|... .. .. ...|=== .. .. ...",
      "1E | ... .. .. ...|... .. .. ...|... .. .. ...|... .. .. ...",
      "1F | ... .. .. ...|... .. .. ...|... .. .. ...|... .. .. ..."
    ],
    "8" : [
      "00 | ... .. .. ...|... .. .. ...|... .. .. ...|... .. .. ..."
    ],
    "4" : [
      "00 | C-6 01v01 ...|... .. .. ...|C-4 03v01 ...|C-5 04v01 ...",
      "01 | ... .. .. ...|... .. .. ...|... .. .. ...|=== .. .. ...",
      "02 | ... .. .. ...|... .. .. ...|... .. .. ...|... .. .. ...",
      "03 | ... .. .. ...|... .. .. ...|... .. .. ...|... .. .. ...",
      "04 | ... .. .. ...|... .. .. ...|... .. .. ...|... .. .. ...",
      "05 | === .. .. ...|... .. .. ...|=== .. .. ...|... .. .. ...",
      "06 | C-6 01v01 ...|... .. .. ...|C-4 03v01 ...|... .. .. ...",
      "07 | ... .. .. ...|... .. .. ...|... .. .. ...|... .. .. ...",
      " -    -    -    -    -    -    -    -    -    -    -    -   ",
      "08 | ... .. .. ...|... .. .. ...|... .. .. ...|D-5 04v01 ...",
      "09 | ... .. .. ...|... .. .. ...|... .. .. ...|... .. .. ...",
      "0A | ... .. .. ...|... .. .. ...|... .. .. ...|=== .. .. ...",
      "0B | ... .. .. ...|... .. .. ...|... .. .. ...|... .. .. ...",
      "0C | C-5 01v01 ...|... .. .. ...|C-3 03v01 ...|... .. .. ...",
      "0D | ... .. .. ...|... .. .. ...|... .. .. ...|... .. .. ...",
      "0E | ... .. .. ...|... .. .. ...|... .. .. ...|... .. .. ...",
      "0F | ... .. .. ...|... .. .. ...|... .. .. ...|... .. .. ...",
      " -    -    -    -    -    -    -    -    -    -    -    -   ",
      "10 | C-6 01v01 ...|... .. .. ...|C-4 03v01 ...|C-5 04v01 ...",
      "11 | ... .. .. ...|... .. .. ...|... .. .. ...|=== .. .. ...",
      "12 | ... .. .. ...|... .. .. ...|... .. .. ...|... .. .. ...",
      "13 | ... .. .. ...|... .. .. ...|... .. .. ...|... .. .. ...",
      "14 | ... .. .. ...|... .. .. ...|... .. .. ...|... .. .. ...",
      "15 | === .. .. ...|... .. .. ...|=== .. .. ...|... .. .. ...",
      "16 | C-6 01v01 ...|... .. .. ...|C-4 03v01 ...|... .. .. ...",
      "17 | ... .. .. ...|... .. .. ...|... .. .. ...|... .. .. ...",
      " -    -    -    -    -    -    -    -    -    -    -    -   ",
      "18 | ... .. .. ...|... .. .. ...|... .. .. ...|D-5 04v01 ...",
      "19 | ... .. .. ...|... .. .. ...|... .. .. ...|... .. .. ...",
      "1A | ... .. .. ...|... .. .. ...|... .. .. ...|=== .. .. ...",
      "1B | ... .. .. ...|... .. .. ...|... .. .. ...|... .. .. ...",
      "1C | C-5 01v01 ...|... .. .. ...|C-3 03v01 ...|... .. .. ...",
      "1D | ... .. .. ...|... .. .. ...|... .. .. ...|... .. .. ...",
      "1E | ... .. .. ...|... .. .. ...|... .. .. ...|... .. .. ...",
      "1F | ... .. .. ...|... .. .. ...|... .. .. ...|... .. .. ..."
    ],
    "0" : [
      "00 | C-6 01v01 ...|... .. .. ...|C-4 03v01 ...|C-5 04v01 ...",
      "01 | ... .. .. ...|... .. .. ...|... .. .. ...|=== .. .. ...",
      "02 | ... .. .. ...|... .. .. ...|... .. .. ...|... .. .. ...",
      "03 | ... .. .. ...|... .. .. ...|... .. .. ...|... .. .. ...",
      "04 | ... .. .. ...|... .. .. ...|... .. .. ...|... .. .. ...",
      "05 | === .. .. ...|... .. .. ...|=== .. .. ...|... .. .. ...",
      "06 | C-6 01v01 ...|... .. .. ...|C-4 03v01 ...|... .. .. ...",
      "07 | ... .. .. ...|... .. .. ...|... .. .. ...|... .. .. ...",
      " -    -    -    -    -    -    -    -    -    -    -    -   ",
      "08 | ... .. .. ...|... .. .. ...|... .. .. ...|D-5 04v01 ...",
      "09 | ... .. .. ...|... .. .. ...|... .. .. ...|... .. .. ...",
      "0A | ... .. .. ...|... .. .. ...|... .. .. ...|=== .. .. ...",
      "0B | ... .. .. ...|... .. .. ...|... .. .. ...|... .. .. ...",
      "0C | C-5 01v01 ...|... .. .. ...|C-3 03v01 ...|... .. .. ...",
      "0D | ... .. .. ...|... .. .. ...|... .. .. ...|... .. .. ...",
      "0E | ... .. .. ...|... .. .. ...|... .. .. ...|... .. .. ...",
      "0F | ... .. .. ...|... .. .. ...|... .. .. ...|... .. .. ...",
      " -    -    -    -    -    -    -    -    -    -    -    -   ",
      "10 | C-6 01v01 ...|... .. .. ...|C-4 03v01 ...|C-5 04v01 ...",
      "11 | ... .. .. ...|... .. .. ...|... .. .. ...|=== .. .. ...",
      "12 | ... .. .. ...|... .. .. ...|... .. .. ...|... .. .. ...",
      "13 | ... .. .. ...|... .. .. ...|... .. .. ...|... .. .. ...",
      "14 | ... .. .. ...|... .. .. ...|... .. .. ...|... .. .. ...",
      "15 | === .. .. ...|... .. .. ...|=== .. .. ...|... .. .. ...",
      "16 | C-6 01v01 ...|... .. .. ...|C-4 03v01 ...|... .. .. ...",
      "17 | ... .. .. ...|... .. .. ...|... .. .. ...|... .. .. ...",
      " -    -    -    -    -    -    -    -    -    -    -    -   ",
      "18 | ... .. .. ...|... .. .. ...|... .. .. ...|D-5 04v01 ...",
      "19 | ... .. .. ...|... .. .. ...|... .. .. ...|... .. .. ...",
      "1A | ... .. .. ...|... .. .. ...|... .. .. ...|=== .. .. ...",
      "1B | ... .. .. ...|... .. .. ...|... .. .. ...|... .. .. ...",
      "1C | C-5 01v01 ...|... .. .. ...|C-3 03v01 ...|... .. .. ...",
      "1D | ... .. .. ...|... .. .. ...|... .. .. ...|... .. .. ...",
      "1E | ... .. .. ...|... .. .. ...|... .. .. ...|... .. .. ...",
      "1F | ... .. .. ...|... .. .. ...|... .. .. ...|... .. .. ..."
    ],
    "5" : [
      "00 | C-6 01v01 ...|... .. .. ...|C-4 03v01 ...|C-5 04v01 ...",
      "01 | ... .. .. ...|... .. .. ...|... .. .. ...|=== .. .. ...",
      "02 | ... .. .. ...|... .. .. ...|... .. .. ...|... .. .. ...",
      "03 | ... .. .. ...|... .. .. ...|... .. .. ...|... .. .. ...",
      "04 | ... .. .. ...|... .. .. ...|... .. .. ...|... .. .. ...",
      "05 | === .. .. ...|... .. .. ...|=== .. .. ...|... .. .. ...",
      "06 | C-6 01v01 ...|... .. .. ...|C-4 03v01 ...|... .. .. ...",
      "07 | ... .. .. ...|... .. .. ...|... .. .. ...|... .. .. ...",
      " -    -    -    -    -    -    -    -    -    -    -    -   ",
      "08 | ... .. .. ...|... .. .. ...|... .. .. ...|D-5 04v01 ...",
      "09 | ... .. .. ...|... .. .. ...|... .. .. ...|... .. .. ...",
      "0A | ... .. .. ...|... .. .. ...|... .. .. ...|=== .. .. ...",
      "0B | ... .. .. ...|... .. .. ...|... .. .. ...|... .. .. ...",
      "0C | C-5 01v01 ...|... .. .. ...|C-3 03v01 ...|... .. .. ...",
      "0D | ... .. .. ...|... .. .. ...|... .. .. ...|... .. .. ...",
      "0E | ... .. .. ...|... .. .. ...|... .. .. ...|... .. .. ...",
      "0F | ... .. .. ...|... .. .. ...|... .. .. ...|... .. .. ...",
      " -    -    -    -    -    -    -    -    -    -    -    -   ",
      "10 | C#6 01v01 ...|... .. .. ...|C#4 03v01 ...|C-5 04v01 ...",
      "11 | ... .. .. ...|... .. .. ...|... .. .. ...|=== .. .. ...",
      "12 | ... .. .. ...|... .. .. ...|... .. .. ...|... .. .. ...",
      "13 | ... .. .. ...|... .. .. ...|... .. .. ...|... .. .. ...",
      "14 | ... .. .. ...|... .. .. ...|... .. .. ...|... .. .. ...",
      "15 | ... .. .. ...|... .. .. ...|... .. .. ...|... .. .. ...",
      "16 | D#6 01v01 ...|... .. .. ...|D#4 03v01 ...|... .. .. ...",
      "17 | ... .. .. ...|... .. .. ...|... .. .. ...|... .. .. ...",
      " -    -    -    -    -    -    -    -    -    -    -    -   ",
      "18 | ... .. .. ...|... .. .. ...|... .. .. ...|C-5 04v01 ...",
      "19 | ... .. .. ...|... .. .. ...|... .. .. ...|=== .. .. ...",
      "1A | ... .. .. ...|... .. .. ...|... .. .. ...|C-5 04v01 ...",
      "1B | ... .. .. ...|... .. .. ...|... .. .. ...|=== .. .. ...",
      "1C | F-6 01v01 ...|... .. .. ...|F-4 03v01 ...|C-5 04v01 ...",
      "1D | ... .. .. ...|... .. .. ...|... .. .. ...|=== .. .. ...",
      "1E | ... .. .. ...|... .. .. ...|... .. .. ...|... .. .. ...",
      "1F | ... .. .. ...|... .. .. ...|... .. .. ...|... .. .. ..."
    ],
    "1" : [
      "00 | C-6 01v01 ...|... .. .. ...|C-4 03v01 ...|C-5 04v01 ...",
      "01 | ... .. .. ...|... .. .. ...|... .. .. ...|=== .. .. ...",
      "02 | ... .. .. ...|... .. .. ...|... .. .. ...|... .. .. ...",
      "03 | ... .. .. ...|... .. .. ...|... .. .. ...|... .. .. ...",
      "04 | ... .. .. ...|... .. .. ...|... .. .. ...|... .. .. ...",
      "05 | === .. .. ...|... .. .. ...|=== .. .. ...|... .. .. ...",
      "06 | C-6 01v01 ...|... .. .. ...|C-4 03v01 ...|... .. .. ...",
      "07 | ... .. .. ...|... .. .. ...|... .. .. ...|... .. .. ...",
      " -    -    -    -    -    -    -    -    -    -    -    -   ",
      "08 | ... .. .. ...|... .. .. ...|... .. .. ...|D-5 04v01 ...",
      "09 | ... .. .. ...|... .. .. ...|... .. .. ...|... .. .. ...",
      "0A | ... .. .. ...|... .. .. ...|... .. .. ...|=== .. .. ...",
      "0B | ... .. .. ...|... .. .. ...|... .. .. ...|... .. .. ...",
      "0C | C-5 01v01 ...|... .. .. ...|C-3 03v01 ...|... .. .. ...",
      "0D | ... .. .. ...|... .. .. ...|... .. .. ...|... .. .. ...",
      "0E | ... .. .. ...|... .. .. ...|... .. .. ...|... .. .. ...",
      "0F | ... .. .. ...|... .. .. ...|... .. .. ...|... .. .. ...",
      " -    -    -    -    -    -    -    -    -    -    -    -   ",
      "10 | C#6 01v01 ...|... .. .. ...|C#4 03v01 ...|C-5 04v01 ...",
      "11 | ... .. .. ...|... .. .. ...|... .. .. ...|=== .. .. ...",
      "12 | ... .. .. ...|... .. .. ...|... .. .. ...|... .. .. ...",
      "13 | ... .. .. ...|... .. .. ...|... .. .. ...|... .. .. ...",
      "14 | ... .. .. ...|... .. .. ...|... .. .. ...|... .. .. ...",
      "15 | ... .. .. ...|... .. .. ...|... .. .. ...|... .. .. ...",
      "16 | D#6 01v01 ...|... .. .. ...|D#4 03v01 ...|... .. .. ...",
      "17 | ... .. .. ...|... .. .. ...|... .. .. ...|... .. .. ...",
      " -    -    -    -    -    -    -    -    -    -    -    -   ",
      "18 | ... .. .. ...|... .. .. ...|... .. .. ...|C-5 04v01 ...",
      "19 | ... .. .. ...|... .. .. ...|... .. .. ...|=== .. .. ...",
      "1A | ... .. .. ...|... .. .. ...|... .. .. ...|C-5 04v01 ...",
      "1B | ... .. .. ...|... .. .. ...|... .. .. ...|=== .. .. ...",
      "1C | F-6 01v01 ...|... .. .. ...|F-4 03v01 ...|C-5 04v01 ...",
      "1D | ... .. .. ...|... .. .. ...|... .. .. ...|=== .. .. ...",
      "1E | ... .. .. ...|... .. .. ...|... .. .. ...|... .. .. ...",
      "1F | ... .. .. ...|... .. .. ...|... .. .. ...|... .. .. ..."
    ],
    "6" : [
      "00 | C-6 01v01 ...|... .. .. ...|C-4 03v01 ...|C-5 04v01 ...",
      "01 | ... .. .. ...|... .. .. ...|... .. .. ...|=== .. .. ...",
      "02 | ... .. .. ...|... .. .. ...|... .. .. ...|... .. .. ...",
      "03 | ... .. .. ...|... .. .. ...|... .. .. ...|... .. .. ...",
      "04 | ... .. .. ...|... .. .. ...|... .. .. ...|... .. .. ...",
      "05 | === .. .. ...|... .. .. ...|=== .. .. ...|... .. .. ...",
      "06 | C-6 01v01 ...|... .. .. ...|C-4 03v01 ...|... .. .. ...",
      "07 | ... .. .. ...|... .. .. ...|... .. .. ...|... .. .. ...",
      " -    -    -    -    -    -    -    -    -    -    -    -   ",
      "08 | ... .. .. ...|... .. .. ...|... .. .. ...|D-5 04v01 ...",
      "09 | ... .. .. ...|... .. .. ...|... .. .. ...|... .. .. ...",
      "0A | ... .. .. ...|... .. .. ...|... .. .. ...|=== .. .. ...",
      "0B | ... .. .. ...|... .. .. ...|... .. .. ...|... .. .. ...",
      "0C | C-5 01v01 ...|... .. .. ...|C-3 03v01 ...|... .. .. ...",
      "0D | ... .. .. ...|... .. .. ...|... .. .. ...|... .. .. ...",
      "0E | ... .. .. ...|... .. .. ...|... .. .. ...|... .. .. ...",
      "0F | ... .. .. ...|... .. .. ...|... .. .. ...|... .. .. ...",
      " -    -    -    -    -    -    -    -    -    -    -    -   ",
      "10 | C-6 01v01 ...|... .. .. ...|C-4 03v01 ...|C-5 04v01 ...",
      "11 | ... .. .. ...|... .. .. ...|... .. .. ...|=== .. .. ...",
      "12 | ... .. .. ...|... .. .. ...|... .. .. ...|... .. .. ...",
      "13 | ... .. .. ...|... .. .. ...|... .. .. ...|... .. .. ...",
      "14 | ... .. .. ...|... .. .. ...|... .. .. ...|... .. .. ...",
      "15 | === .. .. ...|... .. .. ...|=== .. .. ...|... .. .. ...",
      "16 | C-6 01v01 ...|... .. .. ...|C-4 03v01 ...|... .. .. ...",
      "17 | ... .. .. ...|... .. .. ...|... .. .. ...|... .. .. ...",
      " -    -    -    -    -    -    -    -    -    -    -    -   ",
      "18 | ... .. .. ...|... .. .. ...|... .. .. ...|D-5 04v01 ...",
      "19 | ... .. .. ...|... .. .. ...|... .. .. ...|... .. .. ...",
      "1A | ... .. .. ...|... .. .. ...|... .. .. ...|=== .. .. ...",
      "1B | ... .. .. ...|... .. .. ...|... .. .. ...|... .. .. ...",
      "1C | C-5 01v01 ...|... .. .. ...|C-3 03v01 ...|... .. .. ...",
      "1D | ... .. .. ...|... .. .. ...|... .. .. ...|... .. .. ...",
      "1E | ... .. .. ...|... .. .. ...|... .. .. ...|... .. .. ...",
      "1F | ... .. .. ...|... .. .. ...|... .. .. ...|... .. .. ..."
    ],
    "2" : [
      "00 | C-6 01v01 ...|... .. .. ...|C-4 03v01 ...|C-5 04v01 ...",
      "01 | ... .. .. ...|... .. .. ...|... .. .. ...|=== .. .. ...",
      "02 | ... .. .. ...|... .. .. ...|... .. .. ...|... .. .. ...",
      "03 | ... .. .. ...|... .. .. ...|... .. .. ...|... .. .. ...",
      "04 | ... .. .. ...|... .. .. ...|... .. .. ...|... .. .. ...",
      "05 | === .. .. ...|... .. .. ...|=== .. .. ...|... .. .. ...",
      "06 | C-6 01v01 ...|... .. .. ...|C-4 03v01 ...|... .. .. ...",
      "07 | ... .. .. ...|... .. .. ...|... .. .. ...|... .. .. ...",
      " -    -    -    -    -    -    -    -    -    -    -    -   ",
      "08 | ... .. .. ...|... .. .. ...|... .. .. ...|D-5 04v01 ...",
      "09 | ... .. .. ...|... .. .. ...|... .. .. ...|... .. .. ...",
      "0A | ... .. .. ...|... .. .. ...|... .. .. ...|=== .. .. ...",
      "0B | ... .. .. ...|... .. .. ...|... .. .. ...|... .. .. ...",
      "0C | C-5 01v01 ...|... .. .. ...|C-3 03v01 ...|... .. .. ...",
      "0D | ... .. .. ...|... .. .. ...|... .. .. ...|... .. .. ...",
      "0E | ... .. .. ...|... .. .. ...|... .. .. ...|... .. .. ...",
      "0F | ... .. .. ...|... .. .. ...|... .. .. ...|... .. .. ...",
      " -    -    -    -    -    -    -    -    -    -    -    -   ",
      "10 | C-6 01v01 ...|... .. .. ...|C-4 03v01 ...|C-5 04v01 ...",
      "11 | ... .. .. ...|... .. .. ...|... .. .. ...|=== .. .. ...",
      "12 | ... .. .. ...|... .. .. ...|... .. .. ...|... .. .. ...",
      "13 | ... .. .. ...|... .. .. ...|... .. .. ...|... .. .. ...",
      "14 | ... .. .. ...|... .. .. ...|... .. .. ...|... .. .. ...",
      "15 | === .. .. ...|... .. .. ...|=== .. .. ...|... .. .. ...",
      "16 | C-6 01v01 ...|... .. .. ...|C-4 03v01 ...|... .. .. ...",
      "17 | ... .. .. ...|... .. .. ...|... .. .. ...|... .. .. ...",
      " -    -    -    -    -    -    -    -    -    -    -    -   ",
      "18 | ... .. .. ...|... .. .. ...|... .. .. ...|D-5 04v01 ...",
      "19 | ... .. .. ...|... .. .. ...|... .. .. ...|... .. .. ...",
      "1A | ... .. .. ...|... .. .. ...|... .. .. ...|=== .. .. ...",
      "1B | ... .. .. ...|... .. .. ...|... .. .. ...|... .. .. ...",
      "1C | C-5 01v01 ...|... .. .. ...|C-3 03v01 ...|... .. .. ...",
      "1D | ... .. .. ...|... .. .. ...|... .. .. ...|... .. .. ...",
      "1E | ... .. .. ...|... .. .. ...|... .. .. ...|... .. .. ...",
      "1F | ... .. .. ...|... .. .. ...|... .. .. ...|... .. .. ..."
    ]
  },
  "currentPat" : 0,
  "patternOrds" : [
    0,
    1,
    2,
    3,
    4,
    5,
    6,
    7,
    8
  ],
  "numPatterns" : 9
}
